NO textures/north.xpm SO textures/south.xpm
WE textures/west.xpm EA textures/east.xpm
F 50,55,35
C 65,94,120

        1111111111111111111111111
        1000000000110000000000001
        1011000001110000000000001
        1001000000000000000000001
111111111111111111110000000000001
10000000001100000000000000001111
11100000000000000000000000001
10110000000000000000000000001
11100000111111111000000000001
100000000000000000000W0010001
11100000111111111001010010001
11000000110101011111011110011
11110111 1110101 101111010001
11111111 1111111 111111111111
