NO textures/no.xpm SO textures/so.xpm
WE textures/we.xpm EA textures/ea.xpm
F 220,100,0
C 225,30,0

        1111111111111111111111111
        1000000000110000000000001
        1011000001110000000000001
        1001000000000000000000001
111111111011000001110000000000001
100000000011000000000000000011111
11110000000000000000000000001
11110000000000000000000000001
11000000000000N00000000000001
10000000000000000000000010001
10000000000000000001010010001
110000001101010111110111100111
11110111 1110101 101111010001
11111111 1111111 111111111111
