NO textures/no.xpm SO textures/so.xpm
WE textures/we.xpm EA textures/ea.xpm
F 192,192,192
C 102,255,255

        1111111111111111111111111
        1000000000110000000000001
        0011000001110000000000001
        1001000000100000000000001
111111111111111111110000000000001
100000000011000000000000000011111
11110000000000000000000000001
1011000000000000W000000000001
11100000000000000000000000001
10000000000000000000000010001
11100000000000000001010010001
11000000110101011111011110011
11110111 1110101 101111010001
11111111 1111111 111111111111
