
NO ./textures/brickov.xpm
WE ./textures/gravel.xpm
EA ./textures/treerings.xpm
SO ./textures/leavesop.xpm

F    90, 60, 20

C    126, 194, 228




100001111111111111111111
100000000000000000100001
100000000000000000100001
100000001100000000100001
100000001100000000000111
100000000000000111000111
100000000000000100000111
100N00000000000100011111
111111111111111111111111