


NO ./textures/brickov.xpm
WE ./textures/gravel.xpm
EA ./textures/treerings.xpm
SO ./textures/leavesop.xpm

C    126, 194, 228
F    90, 60, 20

111111111 11111
1111N0111 11011
111111111 11111